

NO /home/akovalev/Desktop/42/my-cube3d/NO.png


SO /home/akovalev/Desktop/42/my-cube3d/SO.png
WE /home/akovalev/Desktop/42/my-cube3d/WE.png


EA /home/akovalev/Desktop/42/my-cube3d/EA.png

F 255,100,255

C 255,30,000255






        1111111111111111111111111
        1000000000110000000000001
        1111000001110000000000001
        1001000000000000000000001
11111111101100000111000000000000111
100000000011000001110111111111111
11110111111111011100000010001
111101111111101110101001000111111111
1100000011010101110000001000000000001
1000000000000000110000001000111111111
10000000000000001101010010001
11000001110101011111011110N0111
11110111 1110101 101111010000001
10000000100000001000000000000001
11111111 1111111 11111111111111